{
    "q": "/",
    "w": "׳",
    "e": "ק",
    "r": "ר",
    "t": "א",
    "y": "ט",
    "u": "ו",
    "i": "ן",
    "o": "ם",
    "p": "פ",
    "a": "ש",
    "s": "ד",
    "d": "ג",
    "f": "כ",
    "g": "ע",
    "h": "י",
    "j": "ח",
    "k": "ל",
    "l": "ך",
    ";": "ף",
    "z": "ז",
    "x": "ס",
    "c": "ב",
    "v": "ה",
    "b": "נ",
    "n": "מ",
    "m": "צ",
    ",": "ת",
    ".": "ץ",
    "/": ".",
    "W": "ו",
    "E": "ה",
    "R": "ר",
    "T": "ט",
    "Y": "י",
    "U": "ו",
    "I": "י",
    "O": "ם",
    "P": "פ",
    "A": "א",
    "S": "ס",
    "D": "ד",
    "F": "ף",
    "G": "ג",
    "H": "ח",
    "J": "ג",
    "K": "כ",
    "L": "ל",
    ":": "ך",
    "Z": "ז",
    "X": "ץ",
    "C": "צ",
    "V": "ב",
    "B": "נ",
    "N": "מ",
    "M": "נ",
    "<": "ץ",
    ">": "ת",
    "?": "?",
    " ": " ",
    "1": "1", "2": "2", "3": "3", "4": "4", "5": "5", "6": "6", "7": "7", "8": "8", "9": "9", "0": "0",
    "!": "!", "@": "@", "#": "#", "$": "$", "%": "%", "^": "^", "&": "&", "*": "*", "(": "(", ")": ")",
    "-": "-", "_": "_", "=": "=", "+": "+", "[": "[", "]": "]", "{": "{", "}": "}", "\\": "\\", "|": "|",
    ";": ";", ":": ":", "\"": "\"", "'": "'", "<": "<", ">": ">", ",": ",", ".": ".", "/": "/", "?": "?",
    "`": "`", "~": "~"

}